    item MasonsTrowel
	{
		DisplayCategory = ToolWeapon,
		MaxRange	=	0.9,
        WeaponSprite	=	MasonsTrowel,
        MinAngle	=	0.65,
        Type		=	Weapon,
        MinimumSwingTime	=	4,
        KnockBackOnNoDeath	=	FALSE,
        SwingAmountBeforeImpact	=	0.02,
        Categories	=	SmallBlade,
        ConditionLowerChanceOneIn	=	9,
        Weight	=	1,
        SplatNumber	=	2,
        PushBackMod	=	0.3,
        SubCategory	=	Stab,
        CloseKillMove = Jaw_Stab,
        ConditionMax	=	6,
        MaxHitCount	=	2,
        DoorDamage	=	5,
        SwingAnim	=	Stab,
        WeaponWeight	=	3,
        DisplayName	=	Mason's Trowel,
        MinRange	=	0.61,
        SwingTime	=	4,
        KnockdownMod	=	2,
        SplatBloodOnNoDeath	=	FALSE,
		Icon		=		MasonTrowel,
        BreakSound	= HandShovelBreak,
        DropSound	= HandShovelDrop,
        HitFloorSound	= HandShovelHit,
        ImpactSound	= HandShovelHit,
        DoorHitSound	= HandShovelHit,
        HitSound	= HandShovelHit,
        SwingSound	= HandShovelSwing,
        AttachmentType	= NotKnife,
        TreeDamage 	=   0,
        CriticalChance	=	30,
        CritDmgMultiplier = 10,
        MinDamage	=	0.2,
        MaxDamage	=	0.4,
        WeaponLength = 0.2,
		/*SurvivalGear = TRUE,*/
		Tags = MasonsTrowel,
	}
